NO         ./textures/6.xpm
SO       ./textures/2.xpm
WE    ./textures/4.1.xpm
EA   ./textures/3.xpm

F 100,100,100
C 225,225,255

        111111111111111111111111
        1000000000110000000000001
        1000000000110000000100001
        1011000001110000000000001
        100100000000000E000000001
111111111011000001110000000000001
10000000001100000111011110001111
11110111111111011100000010001
11110111111111011101010010001
11000000110101011100000010011
10000000000000001100000010001
10000000000000001101010010001
1100000111010101111101111000111
11110111 1110101 101111010001
11111111 1111111 111111111111